cloth = klAT
bow (rhyming with "how") = baU?
coo = kuw
am = ?{}m
dead = dEd
roid = rOId
hit = hIt
rouse = raUz
dookie = dUki?
wonder = w@nd@r?
ebb = ?Eb
though = DoU?
loom = lum
lithe = laID
scoff = skAf
tawny = tAni?
dazzle = d{}zl
poverty = pAv@rdi?
thou = DaU?
get = gEt
that = T{}t
lurk = l@rk
ahoy = ?@hOI?
living = lIvIN
shanty = S{}nti?
chain = tSeIn
hem = hEm
sploosh = spluS
Zot = zAt
foible = fOIb@l
churn = tS@rn
the = D@?
then = DEn
loose = lus
fable = feIb@l
thither = DID@r?
teething = tiDiN
lobe = loUb
dame = deIm
hive = haIv
chatter = tS{}t@r?
von = vAn
raunchy = rAntSi?
Jack = dZ{}k
hook = hUk
jowl = dZaU?
voodoo = vudu?
shun = S@n
yay = jeI?
fact = f{}kt
oh = ?oU?
moss = mAs
log = lAg
wince = wIns
zowie = zaUwi?
choose = tSuz
wood = wUd
soy = sOI?
shale = SeIl
nether = nED@r?
they = DeI?
chafe = tSeIf
past = p{}st
deep = dip
giddy = gIdi?
mouse = maUs
prithee = prIDi?
perch = p@rtS
noun = naUn
on = ?An
feel = fil
how = haU?
jeans = dZinz
mesh = mES
let = lEt
girth = g@rT
Zane = zeIn
spook = spuk
pawn = pAn
tub = t@b
merge = m@rdZ
fester = fEst@r?
are = ?Ar
low = loU?
lick = lIk
bye = baI?
and = ?{}nd
posh = pAS
we = wi?
nook = nUk
mud = m@d
Google = gug@l
choy = tSOI?
do = du?
etch = ?EtS
newbie = nubi?
bogey = boUgi?
booger = bUg@r?
up = ?@p
wreck = rEk
vat = v{}t
cape = keIp
life = laIf
never = nEv@r?
yucky = j@ki?
your = joUr
cop = kAp
aitch = ?eItS
hitch = hItS
roach = roUtS
look = lUk
bowl = boUl
ridge = rIdZ
chai = tSaI?
say = seI?
toy = tOI?
ship = SIp
yearn = j@rn
yawn = jAn
tab = t{}b
wool = wul
die = daI?
boil = bOIl
goop = gup
methane = mETeIn
beige = beIdZ
beggar = bEg@r?
wonky = wAnki?
zoo = zu?
zap = z{}p
heart = hArt
choke = tSoUk
gotcha = gAtS@?
butcher = bUtS@r?
Jai = dZaI?
is = ?Iz
me = mi?
dough = doU?
lake = leIk
mush (rhymes with "bush") = mUS
latch = l{}tS
gonna = g@n@?
poing = pOIN
loaf = loUf
furl = f@rl
juvenile = dZuvEnaIl
concrete = kAnkrit
lair = leIr
soak = soUk
thawed = TAd
beam = bim
sour = saUr
Jeff = dZEf
wrath = r{}T
whoa = woU?
here = hir
yow = jaU?
lawn = lAn
bagel (bay-gull) = beIg@l
loud = laUd
Gila = gil@?
should = SUd
leeway = liweI?
mother = m@D@r?
fiddle = fId@l
clash = kl{}S
rook = rUk
curt = k@rt
father = fAD@r?
wayward = weIw@rd
book = bUk
boot = but
joy = dZOI?
lease = lis
third = T@rd
leech = litS
long = lAN
Tim = tIm
tie = taI?
coat = koUt
pope = poUp
Tiffany = tIf@ni?
kite = kaIt
yeah = j{}?
navel = neIv@l
wanly = w{}nli?
take = teIk
fudge = f@dZ
bees = biz
paint = peInt
call = kAl
my = maI?
of = ?@v
pageant = p{}dZEnt
chow = tSaU?
oil = ?OIl
thing = TIN
tell = tEl
line = laIn
hermit = h@rmIt
vug = v@g
cause = kAz
girl = g@rl
phooey = fuji?
poof = puf
class = kl{}s
cone = koUn
adroit = ?@drOIt
pose = poUz
place = pleIs
foul = faUl
rough = r@f
out = ?aUt
Tom = tAm
moist = mOIst
U = ?U?
world = w@rld
hedge = hEdZ
sorry = sAri?
a = ?@?
lathe = leID
home = hoUm
Zen = zEn
lodging = lAdZIN
pang = p{}N
Jake = dZeIk
guide = gaId
fight = faIt
hype = haIp
loath = loUD
moon = mun
bat = b{}t
dawn = dAn
killer = kIl@r?
wet = wEt
roe = roU?
hoop = hup
plum = pl@m
took = tUk
hug = h@g
cat = k{}t
meet = mit
chill = tSIl
hung = h@N
lyre = laIr
you = ju?
put = pUt
rather = r{}D@r?
pet = pEt
cook = kUk
doily = dOI?
nerve = n@rv
moor = mur
toad = toUd
Kenneth = kEn@T
oath = ?oUT
vet = vEt
mat = m{}t
night = naIt
eh = ?E?
zerg = z@rg
coy = kOI?
veal = vil
ethos = ?EToUs
leprosy = lEpr@si?
chalk = tSAk
bicker = bIk@r?
tacky = t{}ki?
shirk = S@rk
vow = vaU?
curse = k@rs
Sally = s{}li?
hike = haIk
sirs = s@rz
second = sEk@nd
zippy = zIpi?
lazy = leIzi?
rude = rud
wren = rEn
hate = heIt
Shaw = SA?
not = nAt
noise = nOIz
the = T@?
bud = b@d
love = l@v
Yiddish = jIdIS
such = s@tS
laid = leId
power = paUw@r?
good = gUd
then = DEn
jerk = dZ@rk
Moshe = moUS
murder = m@rd@r?
yen = jEn
lush = l@S
got = gAt
I = ?aI?
ee = ?I?
it = ?It
happy = h{}pi?
pill = pIl
tower = taUw@r?
to = tu?
halve = h{}v
mitigate = mIdIgeIt
mooch = mutS
burp = b@rp
bearing = bErIN
booth = buT
boy = bOI?
lad = l{}d
scowl = skaUl
wraith = reIT
pie = paI?
Zoe = zoUi?
pithy = pITi?
thigh = TaI?
size = saIz
mice = maIs
down = daUn
vibe = vaIb
knack = n{}k
laugh = l{}f
veil = veIl
thy = DaI?
moth = mAT
pug = p@g
urn = ?@rn
new = nuw
jut = dZ@t
leave = liv
soothe = suD
bother = bAD@r?
joke = dZoUk
sis = sIs
vote = voUt
shower = SaUw@r?
wow = waU?
no = noU?
league = lig
derby = d@rbi?
nerf = n@rf
rove = roUv
maim = meIm
show = SoU?
eel = ?il
royal = rOIj@l
burger = b@rg@r?
right = raIt
ouch = ?aUtS
embezzle = ?EmbEz@l
shepherd = SEp@rd
loin = lOIn
nib = nIb
shy = SaI?
voyage = vOIj@dZ
foe = foU?
leash = liS
mow = moU?
that = D{}t
shoe = Su?
Mookie = mUki?
teeth = tiT
gallant = g{}l@nt
gown = gaUn
in = ?In
check = tSEk
why = waI?
go = goU?
need = nid
Hearsch = h@rS
sheaf = Sif
bonbon = bAnbAn
nip = nIp
ooh = ?u?
away = ?@weI?
lime = laIm
job = dZAb
because = bik@z
