I = aI
the = D@
you = ju
to = tu
and = {}nd
a = @
it = It
not = nAt
me = mi
in = In
my = maI
is = Iz
of = @v
do = du
your = joUr
that = T{}t
on = An
am = {}m
are = Ar
we = wi

love = l@v
oh = oU
got = gAt
never = nEv@r
feel = fil
let = lEt
yeah = j{}
away = @weI
life = laIf
here = hir
heart = hArt
because = bik@z
need = nid
gonna = g@n@
thing = TIN
right = raIt
tell = tEl
night = naIt

boy = bOI
girl = g@rl
should = SUd
meet = mit
how = haU
choose = tSuz
joke = dZoUk
rather = r{}D@r
past = p{}st

Sally = s{}li
laugh = l{}f
wanly = w{}nli
mat = m{}t
knack = n{}k
happy = h{}pi
cat = k{}t
gallant = g{}l@nt
bat = b{}t
tacky = t{}ki
chatter = tS{}t@r
Jack = dZ{}k
fact = f{}kt
vat = v{}t
that = D{}t
zap = z{}p
shanty = S{}nti
pang = p{}N
tab = t{}b
lad = l{}d
latch = l{}tS
pageant = p{}dZEnt
halve = h{}v
wrath = r{}T
dazzle = d{}zl
class = kl{}s
clash = kl{}S

lawn = lAn
raunchy = rAntSi
yawn = jAn
wonky = wAnki
moth = mAT
concrete = kAnkrit
pawn = pAn
bonbon = bAnbAn
tawny = tAni
dawn = dAn
chalk = tSAk
job = dZAb
father = fAD@r
cloth = klAT
von = vAn
thawed = TAd
call = kAl
Tom = tAm
long = lAN
log = lAg
cop = kAp
gotcha = gAtS@
lodging = lAdZIN
scoff = skAf
mauve = mAv
bother = bAD@r
moss = mAs
sorry = sAri
cause = kAz
Zot = zAt
posh = pAS
Shaw = SA

pill = pIl
lick = lIk
Yiddish = jIdIS
wince = wIns
Tim = tIm
mitigate = mIdIgeIt
nip = nIp
hit = hIt
killer = kIl@r
giddy = gIdi
nib = nIb
hitch = hItS
chill = tSIl
ridge = rIdZ
Tiffany = tIf@ni
fiddle = fId@l
living = lIvIN
pithy = pITi
wither = wID@r
this = DIs
sis = sIs
ship = SIp
zippy = zIpi
bit = bIt

bearing = bEIrIN
wren = rEn
wet = wEt
yen = jEn
hem = hEm
wreck = rEk
Kenneth = kEn@T
beggar = bEg@r
get = gEt
leprosy = lEpr@si
pet = pEt
ebb = Eb
dead = dEd
etch = EtS
check = tSEk
Jeff = dZEf
hedge = hEdZ
then = DEn
second = sEk@nd
fester = fEst@r
vet = vEt
nether = nED@r
then = DEn
meth = mETeIn
Zen = zEn
embezzle = EmbEz@l
mesh = mES
shepherd = SEp@rd

yucky = j@ki
wonder = w@nd@r
plum = pl@m
mud = m@d
hung = h@N
hug = h@g
up = @p
bud = b@d
tub = t@b
such = s@tS
fudge = f@dZ
rough = r@f
vug = v@g
shun = S@n
mother = m@D@r
the = D@
lush = l@S
jut = dZ@t
pug = p@g
third = T@rd

wool = wul
moon = mun
spook = spuk
loom = lum
coo = kuw
goop = gup
boot = but
moor = mur
new = nu
newbie = nubi
phooey = fuji
rude = rud
juvenile = dZuvEnaIl
mooch = mutS
poof = puf
booth = buT
hoop = hup
Google = gug@l
voodoo = vudu
soothe = suD
shoe = Su
loose = lus
zoo = zu
sploosh = spluS

book = bUk
look = lUk
rook = rUk
wood = wUd
cook = kUk
Mookie = mUki
nook = nUk
booger = bUg@r
hook = hUk
good = gUd
put = pUt
took = tUk
dookie = dUki
butcher = bUtS@r
mush (rhymes with "bush") = mUS

yearn = j@rn
world = w@rld
hermit = h@rmIt
murder = m@rd@r
nerf = n@rf
lurk = l@rk
burger = b@rg@r
burp = b@rp
derby = d@rbi
curt = k@rt
perch = p@rtS
churn = tS@rn
merge = m@rdZ
jerk = dZ@rk
furl = f@rl
nerve = n@rv
girth = g@rT
curse = k@rs
sirs = s@rz
zerg = z@rg
Hearsch = h@rS
shirk = S@rk
thud = T@d

leeway = liweI
beam = bim
league = lig
Gila = gil@
deep = dip
leave = liv
veal = vil
sheaf = Sif
jeans = dZinz
leech = litS
lease = lis
leash = liS
prithee = prIDi
teeth = tiT
teething = tiDiN
bees = biz

bowl = boUl
low = loU
roe = roU
whoa = woU
home = hoUm
mow = moU
no = noU
bogey = boUgi
go = goU
pope = poUp
lobe = loUb
coat = koUt
toad = toUd
dough = doU
roach = roUtS
choke = tSoUk
loaf = loUf
foe = foU
rove = roUv
vote = voUt
oath = oUT
ethos = eIToUs
loath = loUD
though = DoU
soak = soUk
pose = poUz
Zo = zoU
Moshe = moUS
show = SoU
cone = koUn

veil = veIl
lake = leIk
lair = leIr
yay = jeI
dame = deIm
maim = meIm
wayward = weIw@rd
navel = neIv@l
hate = heIt
cape = keIp
bagel (bay-gull) = beIg@l
paint = peInt
fable = feIb@l
take = teIk
laid = leId
aitch = eItS
chain = tSeIn
beige = beIdZ
Jake = dZeIk
chafe = tSeIf
wraith = reIT
lathe = leID
they = DeI
place = pleIs
say = seI
lazy = leIzi
Zane = zeIn
shale = SeIl

lyre = laIr
why = waI
lime = laIm
line = laIn
hike = haIk
kite = kaIt
guide = gaId
hype = haIp
pie = paI
vibe = vaIb
bye = baI
tie = taI
die = daI
chai = tSaI
Jai = dZaI
fight = faIt
hive = haIv
thigh = TaI
lithe = laID
thy = DaI
mice = maIs
size = saIz
shy = SaI

boil = bOIl
loin = lOIn
royal = rOIj@l
moist = mOIst
poing = pOIN
ahoy = @hOI
noise = nOIz
coy = kOI
adroit = @drOIt
toy = tOI
doily = dOIli
roid = rOId
choy = tSOI
foible = fOIb@l
joy = dZOI
voyage = vOIj@dZ
soy = sOI

scowl = skaUl
loud = laUd
sour = saUr
rouse = raUz
yow = jaU
wow = waU
mouse = maUs
noun = naUn
bow (rhyming with "how") = baU
tower = taUw@r
gown = gaUn
power = paUw@r
out = aUt
down = daUn
ouch = aUtS
chow = tSaU
jowl = dZaU
foul = faUl
vow = vaU
thou = DaU
zowie = zaUwi
shower = SaUw@r

ee = I
eh = E
ooh = u
U = U
urn = @rn
eel = il
oil = OIl
